14151515151515151515151515151514
14141414141414141414141414141414
14151515151515151515151515151514
14151414151515141414141515151514
14151414151515141414141515151514
14151515151515151515151515151514
14151515151515151515151515151514
1415151516151524441515151514
14151515151515151515151515151514
14151514151515151515151515151514
14151514141515151515151515151514
14151514141515151515151515151514
14151514141515151515141415151514
14141415151515151515151515141414
14141415151515151515151515141414
14141414141414141414141414141414
